-8
8
-5
6
00000000000000000
00000000000000000
00000000000000000
00000000000000000
00001000010000000
01100111100011100
01100111100011100
00001000010000000
00000000000000000
01100000000000000
01100111100011100
00000000000000000
